EEEEEEEEEEEEEEE3EEE
EEEEE4EEEEEEEEE4TEE
EEEEEEEEEE4EEEEEEEE
******WWWWWWWWEEEEE
EEEEEEW2EE1ETWEEEEE
ETE1EEWE2E2EEWEEEEE
******WWWWWWWWEEEEE
EEEEEEEEEEEEEEE2EEE
EEETEEEEEEEEEEE3EEE
EEEEEEEEEEEEEEEEE2E